 
█▓▓█▓████▓████████████▓▒▒▒▓▓▒▓▓▓██████████████████████████████████████▓░▒▒░▓████████████████████████████████████▓▓▓▓█▓▓█▓▓▓▓▓▓▓▓▓▓▓▓▓▓▓▓▒▓▓▓▓▓▓▓▓▓▓▓▓▓▓▓▓██████████████████████████████████████████▓░░▒░▓▓█████████████████████████████████████████████▓▓██▓▓▓█████
████████████████▓████▓▓▒░▒▓▓▒▓▓▓████████████████████████████████████████▒░▒░▒▓█████████████████████████████████▓▓▓▓▓▓▓▓▓▓▓▓▒▓▓▓▒▓▓▓▒▓▓▓▓▒▒▒▒▓▒▒▓▒▓▒▒▒▒▒▓▓▓▓▓▓▓▓▓█▓████████████████████████████████▒░▒░▒█▓██████████████████████████▓▓▓█████████████████▓▒▓█████▓▓██
█████████▓███▓█▓▓█▓██▓█▓▒▓█▓░▒▓███████████████████████████████████████████▒░▒░▒██████████████████████████████████▓▓▓▓▓█▓▓▓▓▓▓▓▓▓▓▓▓▓▓▓▓▓▒▓▓▓▓▓▓▓▓▓▓▓▒▓▓▓▓▓█▓████████████████████████████████████▓░░▒░▓████████████████████████▓█▓█▓█▓██████████████████▓████▓▓███▓█
█████████████▓█▓▓█▓███▓▒▓██▓▓▓▓▓██████████████▓▓███▓▓▓██████████████████████▒░▒░▓██████████████████████████████▓▓▓▓▓▓▓▓▓▓▓▓▓▒▓▓▓▓▓▓▓▓▒▓▓▒▒▓▒▓▓▒▓▒▓▓▓▒▓▓▓▓▓▓▓▓▓▓▓███████████████████████████████▒░▒░▓██████████████████████████▓▓▓▓▓▓▓▓██████████████████▓████████▓█
█████▓█▓▓▓███▓█▓▓█▓████▓▓▓▓▓██▓▓█▓▓██▓▓▓▓█████▓▒▓████▓▓██▓▓███████████████████▒▒▒░▓████████████████████████████▓▓▓▓▓▓▓▓▓▓▓▓▓▒▓▓▓▓▓▒▓▓▒▓▓▒▒▒▒▓▓▓▓▓▓▓▓▒▓▓▓▓▓▓▓▓▓▓▓█████████████████████████████▓░▒▒▒███████████████████▓███▓█▓█▓▒▓▓▓▓▓▓▓█████████████████████████████
█████████▓███▓▓▓▓▓▓████████▓█▓▓▓█▓▓▓▓▓▓▓▓▓████▓▓▓▓▓███▓█▓▓▓▓▓▓▓▓▓██████████████████▓█████████████████████████▓▓▓▓▓▓▒▒▓▓▒▓▒▒▒▒▒▒▒▒▒▒▒▒▒▒▒▒▒▒▒▒▒▒▒▒▒▒▒▒▒▒▒▒▒▒▒▒▒▓▓▓▓██████████████████████████▓▓██████████████████▓▓▓██▓███▓█▓█▓▒▓▓█▒▓▒▓███▓▓▓▓███████████████████▓██
█▓▓██████████▓▓▓▓▓▓████████████▓█▓▓▓▓▓▓▓▓▓▓█▓█▓▒▒▓▓▓▓█▓▓▓▓███▓▓▓▓▓▓▓███████████████▓▓████████████████████████▓▓▓▓▓▓▒▓▒▓▒▓▓▒▒▒▒▒▒▒▒▒▒▒▒▒▒▒▒▒▒▒▒▒▒▒▒▒▒▒▒▒▒▒▒▒▒▒▒▓▓▓▓█████████████████████████▓▒▓███████████████▓▓▓▓█▓█▒▓▓█▓▓▓▓█▓▒▒▒█▓▒▓▓█▓█▓▓▓▓▓▓████▓████████▓██████
██████▓▓▓████▓▓▓▓▓▓██▓▓██████████▓▓▓▓▓▓▓▓▓▓█▓▓▒▒▒▓▒▓▒█▓▓▒▒▓▓▓▓▓▓▓▓▓▓▓▓██████████████████████████████████████▓▓▓▓▓▓▒▒▒▒▒▒▒▒▒▒▒▒▒▒▒▒▒▒▒▒▒▒▒▒▒▒▒▒▒▒▒▒▒▒▒▒▒▒▒▒▒▒▒▒▓▓▓▓████████████████████████████████████████▓▓▓▓███▓▒▓▒▓▓▓▓▓▓▓█▓▒▓▒▓▓█▓▓▓▓█▓▓▓▓▓▓▓███▓███▓▓██████████
▓▓▓███▓▓████▓▓▓▓▓▓▓██▓█▓▓▓▓▓█▓▓██▓▓▓▓▓▓▓▓▓▓█▓▓▒▒░▓▒▒▒█▒▒▒▒▓▓▓▓▓▓▓█▓▓▓▓▓▓▓████████████████████████████████████▓▓▓▓▓▓▓▓▓▒▒▒▒▒▒▓▓▓▒▒▒▒▒▒▒▒▒▒▒▒▒▒▒▒▒▒▓▓▒▒▒▒▒▒▒▒▓▓▓▓▓▓█████████████████████████████████████▓▓▓▓▓▓▓▓█▓▓▒▒▓▓▓▓▓▓▒▓▓█▓▒▓█▓▓▓▓█▓▓█▓▓▓▓▓▓▓▓█▓▓███████████████
▓▓▓▓▓▓▓▓▓▓▓▓▓▓▓▓▓▓▓█████▓▓▓▓▓▓▓▓█▓▓▓▓▒▒▒▒▒▓█▓▓▓▒▒▓▒▒▒█▒▒▒░▓▓▓▓▒▒▓▒▓▓▒▒▒▓▓▓▓████████████████████████████████▓██▓▓▓▓▓▓▓▓▓▓▓▓▓▓▓▓▓▓▓▓▓▓▓▓▓▓▓▓▓▓▓▓▓▓▓▓▓▓▓▓▓▓▓▓▓▓▓▓▓▓███████████████████████████████████▓▓▓▓▓▓▓▓▓▓▒▓▓▓▒▓▓▒▓▓▓▓▒▓▒█▓▓▓▓████▓▓▓█▓▓▓▓▓▓▓▓▓▓▓███████████████
█▓▓▓▓▓▓▓▓▓▓▓▓▓▓▓▓▓▓▓▓▓▓███████▓▓█▓▒▓▒▒▒▒▒▒▒█▓▓▒▒▒▓▓▒▒▓▒▒▒░▓▒▒▒▒▒▒▒▓▓▒▒▒▒▒▒▒▓▓▓████████████████████████████▓░░▓▒▒▒▒▒▒▒░░░░░░░░░░░░░░░░░░░░░░░░░░░░░░░░░░░░░░░░░▒▒▒▒▓▒▒▓███████████████████████████▓▓▓▓▓▓▒▒▒▒▒▒▒▓▓▒▒▒▓▒▓▓▓▓▒▒▒█▓▓█▓█▓█▓▓▓▓█▓▓▓▓▓▓▓▓▓▓▓███▓███████████
█████▓▓▓▓▓▓▓▓▓▓▒▒▓▓▓▓▓▓█▓▓▓▓▓████▓▒▒▒▒▒▒▒▒▒█▓▓▒▒▒▒▒▒▒▓▒▒░░▒▒░░▒▒▒░▒▓░░░░░▓▓▒░▒▒▒▓█████████▓███████████████▓░░▓▒▒▒▒▒▒▒░░░░░░░░░░░░░░░░░░░░░░░░░░░░░░░░░░░░░░░░░▒▒▒▒▒▒░▒███████████████▓████████▓▓▒▒▒▒▒▒█▒░░░░░░▓▒▒▒▒▒▒▒▒▓▓░▒▒█▓▓▓▓▓▓▓▓▓▓▓█▓▓▓▓▓▓▓▓▓▓▓███▓█▓▓▓▓██████
▓▓█████▓▓▓▓▓▓▓▓▒▒▓▓▓▓▓▓▓▓▓▓▓▓▓▓█▓▒▒▒▒▒▒▒▒▒▒█▒▒▒▒▒▒▒▒▒▓░▒░░▒▒░░░░░░▒▒░░░░░▒▓▒░▒░░▒▒▓███████░▒█████████████▓▒░░▓▒▒▒▒▒▒▒▒▒▒░░░░░░░░░░░░░░░░░░░░░░░░░░░░░░░░░░░░░▒▒▒▒▒▒▒░▒▓▓████████████▓▒▓██████▓▒▒░░░▒░▒▓░░░░░░░▒▒░▒▒▒▒▒▒▒▒░▒░█▓▓▓▓▓▓▓▓▓▓▓█▓▓▓▓▓▓▓▓▓▓▓█▓▓▓▓▓▓▓▓▓▓▓███
██▓▓▓████████▒▓▒▒▓▓▓▓▓▓▓▓▓▒▓▓▓▓█▓▒▒▒▒▒▒▒▒▒▒█▒▒░▒▒▒▒▒▒▓░▒░░▒▒░░░░░░░▒░░░░░▒▓░░░░░░░▒███████░▒▓████████████▓▓░░▓▓▓▓▒▒▒▒▒▒▒▒▒▒▒░░▒░░░░░░░░░░░░░░░░░░░░░░░░░░░░▒▒▒▒▒▓▓▓▒▒▓█▓███████████▓▒░▓██████▓░░░░░▒░▒▓░░░░░░░▒░░░▒▒▒▒▒▒▒░▒░▓▓▓▓▓▓▓▓▓▓▓▒█▓▓▓▓▓▓▓▓▓▓▓▓▓▓▓▓▓▓▓███████
█▓▓██████████▒▓▒▒▓▓▓▓▓▓▓▓▓▒▒▒▒▒▒▓▒▒▒▒▒▒▒▒▒▒▓▒▒▒▒▒▒▒▒▒▓░▒░░▒▒░░░░░░░▒░░░░░▒▓░░░░░░░▓███████░▒▓▓█▓▓▓█████████▓██▓▓████▓▓▓▓▓▓▓▓▓▓▓▓▓▓▓▓▓▓▓▓▓▓▓▓▓▓▓▓▓▓▓▓▓▓▓▓▓▓▓▓▓▓▓▓▓▓█████████▓▓██▓▓██░░░▓██████▓▓▒░░░░░▒▓░░░░░░░▒░░░▒░▒▒▒▒▒░▒░▓▒▒▓▓▓▓▓▓▓▒▒▓▓▓▓▓▓▓▓▓▓▓▓▓▓▓████████▓▓██
▓▓▓█▓▓▒▓█████▒▓▒▒▓▓▓█████▓▓▒▒▒▒▒▒▒▒▒▒▒▒▒▒▒▒▓▒▒▓▒▒▒▒▒▒▓░▒░░▒▒░░░░░░░▓░░░░░▒▓░░▒░░░▒▓███████▒▒▓████████████████▓▓▒▒▒▒▒▒▒▒▒▒▒▒▒▓▓▒▒▒▒▒▒▒▒▒▒▒▒▒▒▒▒▒▒▒▒▒▓▓▓▓▓▓▓▓▓▓▓▓▓▓▓▓███████▓███████▓░░░▓██████▓▓▒░░░▒░▒▓░░░░░░░▒░░░░░▒▒▒▒▒░▒░▓▓▓▓▓▓▓▒▒▒▒▒▒▒▒▒▓▓▓▓▓▓▓████████████████
▒▓▓▓▓▒░▒▒████▒▓▒▒▓▓████▓██████▓▓▒▒▒▒▒▒▒▒▒▒▒▒▒▒▓▒▒▒▒▒▒▓░▒░░▒▒░░░░░░▒▓░░░░░▒▓░▒▒▒▓▓▓▓███████▓▓▓▓▓▓▓▓▓▓▓▓▓███████▓▒▒▓▓▓▒▓▒▒▒▒▒▒▓▓▓▓▒▒▓▒▓▓▒▒▒▒▒▓▓▓▓▒▒▓▓▓▓▒▒▓▒▒▓▓▓▒▒▒▒▒▓██████▓█▓███████░▒░███████▓▓▒▒▒░▒░▒▓░░░░░░░▒░░▒▒▒▒▒▒▒▒░▒░▒▒▒▒▒▒▒▒▒▒▒▒▒▒▒▓▓▓▓████████████████████
██▓▓▓▒▒▒▓▓███▒▓▒▒▓▓▓███████████████▓▒▒▒▒▒▒▒▒▒░▒▒░░▒▒▒▒░▒░░▒▒░░░░░░▒▒░░░░░▒▓▒▒▓▓▓▓▒█████████▒▒▓▓▓▓▒▒▒▓▒▓███████▓▒▒▓▓▒▒▒▒▓▓▒▒▓▓▓▓▓▒▒▒▒▒▒░░░▒▒▒▒▒▒▒▒▓▓▓▓▒▒▒▓▒▓▓▓▓▒▓▒▓███████▓██▓█████▓░▒░███████▓▓▒▒▒▒▒░▒▓░░░░░░░▒▒░░▒▒▒▒▒░▒░▒░▒▒░▒░▒▒▒▒▒▒▓▓▓▓▓▓▓▓▓██████████▓▓█▓▓▓███
█▓███████████▒▓▒▒▓▓███████████▓▓████████▓▒░▒▒░░░░░░▒▒░░▒░░▒░▒▒▒▒░░▒▒░░░░░▓▓▒▒▓▒██▒█████████▓▓▓▓▒▓▓▒▓▒▓▒███████▓▓▓▓▓▓▓▓▓▓▓▓▓▓▓▓▓▓▓▒▒▒▒▒▒▒▒▒▒▒▒▒▒▓▓▓▓▓▓▓▒▒▒▓▓▓▓▓▓▓▓▓███████▓▓▓▓▓▓▓▓▓▓░▓▒███████▓█▒▒▓▒▒░▒▓▒░░░░░░▒▒▒▒▒▒▒▒▒░▒░▒░░░░░░▒▒▓▓▓▓▓▓▓▓░░▒░░░░▓█████▓█▓▓▓▒▓████
███▓▒▓▓██████▒▓▒▒▓▓██████▓▓▓▓▓▓▓▓▓▒░░░░▓█████▓▒▒░░░░░░░▒░░▒▒▒▒▒▒▒▒▒▒░░░░░▓▓▒▒▓▓██▓█████████▓▒▓▓▓▓▒▒▒▒▒▓███████▓▓▓▓▓▒▓▓▒▒▓▓▓▓▓▓▓▓▒▒▒▒▒▒▒▒▒▒▒▒▒▒▒▒▒▓▓▓▓▒▒▒▒▓▓▒▒▓▓▓▓▓▓████████▓▓▓▓▓▓▓▓▒▓▒███████▓█▓▓▓▓▒▒▒▓▒░░░░░░▒░░▒▒░▒░░░▒░▒░▒▒▓▓▒▒▒▒▓▓▓▓▒░░░░░▓▓▓▓▒▒▓██▓▓▓▒▒▓▓▒▓███
▓██▓█████████▒▓▒▒▓▓▓███▓▒▒▒▓▓▓▓▓▒░░▒░░░░░▒████████▓▒▒░░▒░░░░░░░▒▒▒▒▒░░░░▒▓▓▒▒▓▓████████████▓▓▓▒▒▒▒▒▒▓▒▓███████▓▒▒▒▒░░░░▒▒▒▒▒▓▓▓▓░▒▒▒▒▒▒░░▒▒▒▒▒▒▒▒▓▓▓▓▒▒▒▓▓▒▒▒▓▓▓▓▓▓███████▓▓▓▓▓▓▒▓▓▓▓▓███████▓▓▒▒▓▓▓▒▒▓▒░░░░░░░▒▒░░░░░░░▓░▒░█▒▒▒▒▒▒▓▓▓▓▒░▒▒▓▓▒▓▓▓▓▓▒▒▓▓▓▓▓▓▓▓▒▒▓▓██
█████████████▒▓▒▒▓▓▓██▓░░▒▒▒▓▓▓▓░▒▒▒▒▒░▒▒▒░▓██████████░▒░░▒▒░░░░░░░░░▒▒▒▒▓▓▒▒▓▓▓█▓█████████▓▓▓▓▓▓▓▓███████████▓▓▓▓▓▓▒▒▓▓▓▓▓▒▓▓▓▒░▒▒▒▒▒░░░░▒▒▒▒▒▒░▒▓▓▓▓▓▓▓▓▓▓▓█████████████▓▒▒▒▒▓▓▓▓▓▓▓███████▓▓▓▓▓▓▓▒▒▓▒▒░░▒░░░░░░░░▒▒▒▒▓░▒░█▒▒▒▒▓▓▓▓▓▓░▒▒▓▓▓▓▓▓▓▓▓▓▓▓▓▓▒▒▓▓▒▒▓▓███
██▓██████████▒▓▒▒▓▓███▓▒░░░▒▒▒▒▒░▒▓▓▓▓▓▒▓▓▓▒▓▓▓▓▓▓▓▓██▒▒░░▓█▓█▓▓▒░░░░░▒▒▒▒▒▒▒▓▓████████████▓▒▒▓▓▓▓██▓▓████████▓▒▒▒▒▒▒▒▓▓▓▓▒▓▓▓▓▒▒▒▒▒▒▒▒░░░▒▒▒▒▒▒▒▒▓▓▓▒▓▒▒▒▒▓▓▓▓▒█████████▓▒▒▒▒▒▒░▒░▒▒▒███████▓█▓▓▓▓▒▒▒▒▒▒░░░░░░▒▒▒▒▒▒▒▒▒▓░▒░█▒▒▒▓▒▓▓▓▓▒▒▒▓▓▓▓▓▒▓▓▓▓▓▓▓▓▓▓█▓██▓█████
▓▓█▓█████████▒▓▒▒▓▓████▒▒░░░░▒▒▒░▒▓▓▓▓▓▓▓▓▓▒▒▓▓▓▓▓▒▒▓█▒▒▒░▓▓▓▓▓▓▓▓▓█▓▓▒▒░▒▒▒▒▓▒▓▓██████████▓▒░▓▓▓▓██▓▒▓████████▓▓▓▓▓▓▓▓▓▓▓▓▓▓▓▓▒▒▒▒▓▒▒▒▒░▒▒▒▒▒▒▒▒▓▓▓▓▓▓▓▓▓▓▓▓▓▓▓▓▓███████▒░░░░░░░░░░░░███████▓█▓▓▓▒▒▒▒▒░░░▒▒▒▒▒▒▒▒▒▒▒▒▒▒▓░▒▒█▒▒▒░▒▒▒▒▒▒▒▒▓▓▒▓▓▒▓▓▓▓▒▒▓█████████████
▓▓▒▓▓▓█▓█▓███▒▓▒▒▓▒█████▒░░░▒▒▒░░░▒▒▓▓▓▒▓▓▓▓▓▓▓▒▒▓▓▓▓█▒▒▒░▓▓▓▓▓▓▓▓▓▓▓▒▒▓██▓▒▒▒▓▓▓██████████▓███▓▓▓▓▓▓▓▓███████▒▒▒░▒▓▓▓▓▒▒▓▓▓▓▓▓▓▒▒▒▒▒▒▒▒▒▒▒▒▒▒▒▒▓▓▓▓▓▓▓▓▓▓▓▓▓▓▓▓██▓███████▓▓▓▓▓▓▓▓▓▓▓▓███████▓▓▓▓▒▒▒▒▓▓▓▒▒▒▒▒▒▒▒▒▒▒▒▒▒▒▒▓░▒▒█▒▓░░░░░░▒░░▒▒▓▓▓▒▓▓▓▒▒▒▒▓███████▓█████
█▓▒▓▓▒▓▒▓▓███▒▓▒▒▓▓██████▒▓▓▓▓▓▒░░▒▒▒▓▓▒▓▓▓▒▒▒▓▒▒▓▒▓▓█▒▒▒▒▓▓▓▒▒▓▓▓▓▒░░░░░▓█████████████████▓▓▓▓▓▓▓▓▓▓▓▓███████▒▒▒▒▒▓▓▓▓▓▓▒▒▒▓▓▓▓▓▓▒░▒▒▒▒▒▒▒▒▒░▒▓▓▓▓▓▓▒▓▓▒▓▓▓▒▓▓▒▓▓▓██████████████████████████▓▓▓▓███▓▓▓▓▓▓▒▒▒▒▒▒▒▒▒▒▒▒▒▒▓▒▒▒█▓▓░░░░░▒▒░░▒▒▒▒▒░▓▓▓▒▒▒█▓█████████████
▓▓▓▓▓▓▓▓█████▒▓▒▒▓▓████████▓▓▓██▓░░░░▒▒▓▓▓▒▒▒▓▓▓▓▓▓███▒▒▒▒▓▓▓░▒░▓▓▒░▒▒▒░▒▒▒████████████████▓▒▒▓▓▒▒▓▓▒▒▓███████▒▒▒▒▓▓▓▓▓▓▓▓▓▓▓█▓▓▓▓▓▓▒▒░░░░░▒▒▓▓▓▓▓▓▓▓▒▒▒░▒░▒░▒▒░░░▒████████▓▒▓███▓▒▒█████████▓█▓▓▓▓▓▓▓▓▓▒▒▒▒▒▒▒▒▒▒▒▒▒▒▓▒▓▒▒▒█▓▓▓░░▒▓▓▓▓▒░░░░▒▒▒▓▓▒▒████▓▓█▓████████
▓▒▓▒▓▓▓▓▓▓███▒▓▒▒█▓██████▓▓██████▓░░░░▒▒▓▓▒▒▓███▓▓████▒▒▒▒▓▓▒░░░░░▒░▒▒▒▒▒▓▒▓▓▓▓▓▓██████████▓▒▒▓▓▒▒▓▓▓▓██████████████▓▓▓██▓▓▓██▓▓▒▓▒▓▓▓▓▓▓▓▓▓▓▓▓▓▓▓▓▓▒░░░░░░░░░░░░░░███████▒▒▒▒▒█▓░░░░▓███████▓█▓▓▓▓▓▓▓▒▒▒▒▒▒▒▒░▒▒▒▒▓▓▓▓▓▓▒▒▒█▓▓▓▓▓▓▓▓▓██▒░░░▒▒▒▒▒▒███▓▓▒▒▒░▒▒▒▒▒▒▓█
▓▓▓▓▓▓▓▓▓▓▓██▒▓▒▒█▓██▓▓▓▓▓▓█▓█████▓░░░▒░▒▒▒▓██▓▓▓▓▓▓▓█▒▒▒▒███▒░░░░░░▒▒▒▒▒▒▓▒▓▓▒▓▓▓████████████████████████████▓▓▓▓▓▓▓▓▓▓▓▓▓▓▓▓▓▓▓▓▓▓▓▓▓▓▓▓▓▓▓▓▓▓▓▓▓█▓▓▓▓▓▓▓▓▓▓▓▓▓▓▓███████▓░▒░▓██▒░░▓████████▓█▓▓▓▓▓▒▓▒▒▒▒░▒░░░░░▒▒▒▓▓▓▓▓▒▓▒█▓█▓█▓███████▓░░░░▒▓▓███▓▒▒▒▒▓▓▓▓█▓▓▒▓█
█████████████▒▓▒▒█▓██▓▓▓▓█▓█▓▓▓▓████▒░░░▒▒▓██▓▓▓▓▓▓▓▓█▒▒▒▒████▒▒▒▓▒░░▒▒▒▒▒▒▒▓▓▒▓▓▓█████████▓▓▓▓▓▓▓▓▓▓▓▓███████▓▓▒▒▒▒▒▒▒▒▓▓▓▓▓▓█▓▓▒▒▓▒▒▓▓▓▓▓▓▒▒▒▓█████▓▓▓██▓▓████▓▓███████████████████████████▓█▓▓▒▓▒░▒▒░░▒░▒░▒▒▒▒▒▓▓▓▓▓▓▓▒▓▒███████████████▓▒▒███████▓▓▓▒▒▒▒▓▓▒▒▒▓█
▓▓▓▓▓▓▓▓▓▓▓▓▓▓▓▒▒▓▓████▓▓▓▓▓▓▓▒▓█████▓▒▓█████▓▒▓▓▓▓▒▓█▒▒▒▒███▓█▓▓▓▓▓░░░░▓▒░▒▓█▓█▓█████████▓▓▓▒▓▓▒▓▓▒▓▓▒███████████████████▓▓▓██▓▓▓▓▒▓▒▒▓▓▓▒░▒▓▒▒▓▓██▓▒▓▓▓▓▓▒▒█▒▓█▓▓███████▓▓▓▓▓▒▓▓▒█▓▓█████████▓▓░▓▓▒▒▒▒▒▒▓▓▓▓▓▓██████▓▓▓▒▓▒█▓▓▓▓▓▓█▓▓█████████████████████████████
█▓▓▓▓▓▓▓▓▓▓▓▓▓▓▒▒▓▒▓▓▓▓▓▓▓███████████████████▓▓▓▓▓▓▓▓█▒▒▒▒████▓█████▒░░▒▒▒▒███▓▓▒▓████████▓▓▓▓▓▓▒▓▓▒▓▓▓████████▓▓▓▓▓▓▓▓▓▓▓▓▓▓██▒▓▓▒▒▒▓▒▓▓▓░▓▒▒▒▓▒▓██▓▓▒▓▒▒█▒▓█░▓▓▒▓███████▓▓▓▓▓▓▓▓▓▓▓▓█████████▓▓▓▓▓▓▓▓▓█▓███▓▓▓████▓▒▓█▓▒▓▓█▓▓▓▓▓▓▓▓▓██████████▓▓▓▓▓▓▓▓▓▓▓▓▓▓▓▓▓▓▓
▓▓██████████▓▓▓▒▒▓▓▓▓▓▓▓▓▓▓▓▓▓▓▓▓▓▓▓▓▓▓▓▓▓▓█████▓▓▓▓▓█▒▓▒▒██▓█▓█▓▓▓██▒░░▒▒████████████████▓▓▓▒▓▓▓▓▓▒▓▓▒███████▓▒▒▓▒▒▒▒▒▓▓▓▓▓▓█▓▓▒▓▓▓▓▒░▓██▒▒▒▓▒▒▓▓██▓▓▓▓▓▓▓▓▓▓▓▓▓▓▓████████████████████████████▓▓▓█▓▓▓▓▓██▓█▓█▓▓▓▓▓▓▓▒▒█▓▓▓▓██████▓▓▓▓▓▓▓▓▓▓▓▓▓▓▓▓▓▓▓▓▓▓▓▓▓▓█▓▓▓▓▓▓
████████████▓▓▓▒▒▓▒▓▓▒▓▓▒▓▓▓▓▓▒▒▓▓▒▒▒▒▒▒▒▒▒▒▒▒▒▒▒▒▒▒▒▒▒▓▒▒▓███▓▓▓▓▓███▓▓████▓▓████████████▓▓▓▒▓▓▒▓▓▒▓▓▒███████▓▓▓▓▓▓▓▓▓▓▓▓▓▓▓████▓▒▒▒▓▓████▓▒▒▒▓████▓▓▓▓▓▓█▓▓▓▓▓▓▓████████▓▓▓▓▓▒▓▓▓█▓▓█████████▓▓▓▓▓▓█▓█▓██████▓▒▓▓▓███▓▓▓▓▓▓▓▓▓▓▓▓▓▓▓▓▓▓▓▓▓▓▓▓▓▓▓▓█▓▓▓▓▓▓▓▓▓▓▓▓▓▓▓
████████████▓▓▓▒▒▓▒▓▒▒▒▓▒▒▒▒▒▒▒▒▓▒▒▒▒▒▒▒▓▓█▓▓▓▓▓▓▓▓▓▓▓▒▓▒▒▓▓▓▒▒▓▓▓▓▓▓▓▓██████▓▓▓▓▓████████▓▓▓▒▓▓▓▓▓▓▓▓▓██████▓▓▒▓▓▓▓▓▓▓▓▓▓▒▓▓██▓▓▓▓▓▓▓▓▓▓▓▓▓█████▓██▒▒▓▒▒▓▓▓▓▓▓▓▓▓▓███████▓▓▓▓▓▓▓▓▓▓▓▓█████████▒▓▒▒▓█████▓▓▓▓▓▓▓▓▓▓▓▓▓▓▓▓▓▓▓▓▓▓▓▓▓▓▓▓▓▓▓▓▓▓▓▓▓▓█▓▓▓▓▒▓▓▓▓▓▓▓▓▓▓▓▓██
▓▓▓▓▓▓▒▓▓▓▓▓▓▓▓▒▒▓▒█▓▓▓▓▒▒▓▓▒▓█▓█▓▒▒▓▒▒▒▒▒█▓▓▒▒▒▓▓▓▓▓█▒▓▒▒▓▒▒▒▒▓▓▒▓▓▒▒▒▒▒▒▒▓▓▓▓▓██████████▓▓▒▒▓▓▓▓▓▒▓▓▓███████▒▒▒▒▒▓█▓▓▓▒▓▓▓▓█▓▓▓▒▒▒▒▒▒▓▒▓▒▒▓▓▓▓▒▒▓█▓▓▓▓▓▓▓▓▓▓▓▓▓▓▓███████▓▓▓▓▓▓▓▓▓█▓██████████▓▓▓▓▓▓▓▓▓▓▓▓▓▓▓▓▒▒▓▒▒▒▓▓▓▓▓▓▓▓▓▓▒▒▒▒▓▓▓▓▓▓▓▓▓▓▓▓▓▓▓▓█▓▓▓██▓▓▒███████
▓▓▓▓▓▓▓▓▓▓▒▓▓▓▓▓▓▓▓▓▓▓▓▓▓▓▓▓▓▓▓▒▒▒▒▒▒▒▒▒▒▒▒▓▓▓▓▓▓▓▒▓▓▓▒▓▒▒▓▒▒▒▒▒▓▓▓▓▒▒▒▒▒▒▓▓▒▒▓▓▓▓██████████████████████████████▓▓▓████▓▓▓▓▓▓▓▒▒▒░▒▒░░▒░▒▒░░░▒▒▒▒░▓█▓▓▓▓▓▓▓▓▒▓▓▓▓▓▓███████▓▓▓██▓██████████████▓▓▓▓▓▓▓▒▓▓▓▓▓▓▓▓▓▓▓▓▓▓▓▓▓▓▓▓▓▓▓▓▓▓▓▒▓▓▓▓▓▓▓▓▓▓▓▓▓▓▓▓▓▓▓▓▓▓▓▓▓▓▓▓█████
▓▓▓▓▓▓▓▓▓▓▓▓▓▓▓▓▓▓▒▓▒▒▒▒▒▒▒▒▒▒▒▒▒▒▒▒▒▒▒▒▒▒▒▒▒▒▒▒▒▒▒▒▒▒▒▓▒▒▒▒▒▒▒▒▒▒▒▒▒▒▒▒▒▒▒▓▓▓▓▓▓▓█████████▓▓▓▓▓▓▓▓▓▓▓▓███████▓▓▓▓▓▓▓▓▒▒▒▒▒▓▓▓░░░░░░░░░░░░░░░░░░░░▒▓▒▒░▒░▒▒▒░░░▒▒░▒██████▓▒░▒▒▒▒▒▒▒▓▒▒████████▓▓▓▒▒▓▓▓▓▓▓▓▓▓▓▓▓▓▓▓▓▓▓▓▓▓▓▓▓▓▓▓▓▓▓▓▓▓▓▓▓▓▓▓▓▓▓▓▓▓▓▓▓▓▓▓▓▓███████████
████████████████████████▓▓▓▓▓▓▓▓▓▓▓▓▓▓▓▓▓▓▓▓▓▓▓▓▓▓███▓▒▒▒▒▒▒▒▒▒▒▒▒▒▒▒▒▒▒▒▒▒▒▒▒▒▒▓▓█████████▓▓▓▓▓▓▓▓▓▓▓▓███████▓▓▓▓▓███▓▓▓▓▒▓▓▓▓▓▓▓▓▓▓▓▓▒▒▒▒▒▒▒▒▓▒▓▓█▓▓▓▓▓▓▓▓▓▓▓▓▓▓▓██████▓▒▒▒▓▓▓▓▒▓▓▒▒████████▓▓▓▓▓▓▓▓▓▓▓▒▒▒▒▒▒▓▓▓▓▓▓▓▓▓▓▓▓████▓▓▓▓▓▓▓▓▓▓▓▓▓▓██▓████▓▓█████████████
▒▒▒▒▒▒▒▒▓████████████▒▒▓▒▒▓▒▓▒▒▒▒▒▒░░▒▓▓▓██▓▓▒▓▓▓██▓███▓▓▓▒▒▒▒▒▓▒▓▓▓▓▓▓▓▓██▓▓▒░░░░▒▒▒▓▓████▓▓▓▓▓▓▓▓▓▓▓▓██▓████▓▓▓▓▓▓█▓▓▓▓▓▓▓███▓▓██▓▓▓▓▓█▓▓▓▓▓▓▓▓██████▓▓▓██▓▓▓▓█▓████████▓▓▓▓▒░░▓▓▓▒▓████▓▓▓▓▓▒▒▒▒▒▓██▓▓▓▓▒▒▒▒▒▓▓▓▓▒▒▒▓▓███▓██▓▒▒▒░▒▒▓▓▓▓▓▒▓▓▓▓▓▓▓▓▒▒░▒▒▒▒▒▒▓█████
▓▓▒▒▒▒▒▒▓▒▓█████████▓▓▓▓▓▓▓▓▓▓▓▒░░░░▒▒▒░▒▒▒▓▓▓▓▓▓▓▓██▓███▓▓▓▓▒▓▓▒▓▓▓▓▓▓▒▒▓▓▓██▓▒▒░░░░░▒▒▓███▓▒▓▓█▓▓▓▒▒▒██████▓▓▒▒▒▒▒█▒░▒▓▓▒▒▓█▓▒▒▓▓▓▒▒▓▓▓▓▓▓▓▓▓▒▓▓██▓██▓▓▒▓▓▓▒▒▓▓▒▓███████▓▓▓▓██▓▓██▓▓█▓▓▓▓▒▒▒▒▒░▒▓██▓▓▓▒▒▓▒▒▓▓▓▓▓▒▒▒▓▓███▓██▓▒▓▓▓▓▓▓▓▓▓▓▓▒▓▓▓▓▓▓▓▒▒░▒░░▒░░▒███████
▓▓▓▒▒░▒░░░▓▓██████████▓█▓█▓▓▓▓▓▓░░░░▒▒▒▒▒▒▒▒▒▓▓▓▓▓▓▓▓██▓███▓▓▓▓▓▓▓▓▓▓▓▓▓▓▒▒▓▓▓██▓▒░░░░░▒▒▒▓▓▓▓███████████████▓▓▓▓▓▓▓█▓▓▓▓▓▓▓███▓▓▓█▓▓▓▒▓▓▓▓▓▓▓██▓▓██▓▓▓▓▓▓▓█▓▓▓▓▓▓▓████████████▓████▓▓▒▒▒░░▒▒▒░▒▓██▓▓▒▒▒▒▒▓▒▓▓▓▓▓▓▓▓▓███▓██▓▒▒▒▓▒▓▒▒▒▓▒▒▓▓▓▓▒▓▓▓▓▓▓▓▓▓▓▓▓▓█████████
██▓▓▓▓▓▓▓▓▓▓▓▓██████████▓▓▓▒▓▒▒▒▒░░░░░░▒▒▒▒▒▓▒░▓▓▓▓▓▓▓▓██▓███▓▓▓▓▓▒▒▒▒▒▒▒▒▒▒▒▒▓▓██▓▒▒▒░░░▒▒▒▒▓▓████████████▒▒▓▒▓▒▓▓▒▒▒▒▓▓▓▓▓▒▓▓▒▓▒▒▒▓▒▒▒▒▓▒▒░░▒▒▒▒░▒▓▓▓▒▓▒▒▓▓▓▒▒▒▓▓▓▓█████████████▓▓▒▒▒░░▒▒░░▒▓██▓▓▒▓▒▒▒▒▒▒▒▓▓▓▓▓▓▓███▓▓█▓▒▒▒▒▒▒▒▒▒▒▒░▒▓▓▒▒▒▒▒▒░░▒▒▒▒░░▒▓██████████
▓▓▓▓██▓▓█▓█▓█▓▓▓████▓████▓▓▓▓▓▒▓▒▓▒░░░░░░▒▒▒▒▒▒░▒▓▓▓▓▓▓▓▓██▓███▓▓▓▓▓▒▒▒▒▒▒▒▒▒▒▒▒▓▓██▓▒▒▒▒▒▒▒▒▒▓▓▓███████████████████████████████████████████████████████████████████████████████▓▓▒▒░▒░░▒░▒▒▓██▓▓▒▒▒▒░▒▒░░░▒▒░▓▓▓███▓▓█▓▓▒▒▒▒░▒▒▒▒▒▒▒▓▓▒▒▒▒▒▓▒▓▓▓▒▒▒▒▓▓▓▓██████████
▓▓▓▓▓▒▓▓▓▓▓▓▓▓▓▓▓██████████▓▓▓▒▓▓▓▒▓▓▒░░░░░░▒▒▒▒▒▓▓▓▓▓▓▓▒▒▓██▓███▓▓▒▒▓▒▒▒▒▒▒▓▓▓▓▓▓▓▓██▓▓▓▓▒▒▒▒░▒▒▒▒▓▓███████████████████████████████████████████████████████████████████████▓▒▒▒▒▒▒░░░▓▓▓▓▓█▓▓▓▓▒▒▒▒▒▒▒▒▒▒▒░▒▓▓███▓██▓▒░░▒▒░▒▒▒▒▒▒▓▓▓▓▒▒░▒▒░░░░░░░░░▒█▓█████▓██████
▓▓▓▓▓▓▓▓▓▒░░░░▒▒▒▒▒▓███▓█████▓▓▓▓▓▓▓▓▓▓▓▒░░░░░░░░▓▓▓▓▓▓▓▓▓▓▓▓█▓▓███▓▓▓▓▓▒▓▒▒░░▒░▓▓▓▓▓▒▓█▓▓▒▓▒▒▒▒▒▓▒▒▒▒▒▒▓▓▓▓████████████████████████████████████████████████████████▓▓██▓▓▓▓▒▒▒▒▒▒▒▒▒▒▒▓█▓▒▓▒▓▓▒░░░░▒▒▓▓▓▓▓▓▓███▓▓█▓▓▒▒▒▓▓▓▓▓▓▓▓▓▓▓▓▒▒░▒▒▒░░░░░░░░▒▓▓▓███████████▓▒
▓▓▓▓▓▓█▓▓▓▓▒░░░▒▓▓▓▓▓▓███▓▓████▓▓▓▓▓▓▓▓▓▓▓▓▓▒▒▒▒▒▒▓▓▓▓▓▓▓▒▓▓▓▓▓▓▓▓███▓▓▓▓▓▓▓▓▓▒▒░▒▓▒▓▓▓▓▓▓▓▒▒▒▒▒▒▓▓▓██████▓▓████████████████████████████████████████████████████████▓▓▓█▓▓██▓▒▓▓▓▓▓▓▓▓▓▒▒▓▒▒▒▒▒▒▒▒▒▒▓▓▒▒▓▓▓███▓▓▓▓▓▓▓▓▓▓▓▓▓▓▓▒▒▓▓▓▒▒░▒▓▒▓▓▓▓▓▓▓▓▓▓▓▓███████████▓▓▒▒
▒▒▓▓▓▓▓▓▓▓▓▓▓▓▓▓▓▓▓▓▓██████▓█████▓▓▓▓▓▓▓▓▓▓▓▓▓▒▒▒▒▒░▒▒▒▒▓▓███▓▓▓▓▒▒▒▓███▓▒▒▓▓▓▒▒▒▒▒▒▒▒▒▒▒▓▓▓▓▓██▓▓▓▓▓██▓██▓▓█████████████████████████████████████████████████████████▓▓█████▓▓▓██████▓▓▓▓▓▓▒▒▒▒▒▒▒▒▒▒▒▒▓███▓▒▒▒▒▒▓▓▓██▓▓▒▒░▒░▒▒▒▒▒▒▒▒▓▓▓▓▓▓▓▓▓▓▓▓▓████▓▓█████▓▓▓▓▓▓
▓░▒▒▓▓▓▓▓▓██▓▓▓▓▓▓▓▓▓▓██████▓▓█████▓▓▓▓▓▓▓██▓▓▓▒▒▒▒▒▒▒▓███▓▓▓▓▒▒▓▒▒▓▓▓▓▓▓▓▓▓▒▒▒▒▒▓▓▓▓▓▓▓███▓▓██████▓▓█████▓▓████████████████████▓██████████████▓████████▓████████████▓███▓██▓▓▓██████▒▓██▓█▓▓▓▓▓▓▓▓▓▓▓█▓▓▓▓▓▓▒▒▒▒▓███▓▒▒▒▓▒▒▒▒▒▒▒▒▒▓▓▓██▓▓▓▓▓▓▓▓█████▓███████▓█▓▓▓▓
▓▓▓▓▓▓█▓▓▓██▓▓▓▓▓▓▓▓▒▒▓▓█▓▓█▓▓▓▓████▓▓▓▓▓▓▒▒▒▒▓▒▒▓▓▓▓▓▓▓▒▓▓▓▓▒▒▒▓▒▒▒▒▒▒▒▒▒▓▓▓▓▓█▓▓█████▒▓▓▓█▓▓▓▓▓▓███▓█▓██▓▓▓███▓▓▓▓▓▓▓▓▓▓▓▓▓▓▓▒▓▓▓▓▓▓▓▓▓▓▓▓▓▓▓▓▓████▓▓▓▓▓▓▓▓▓▓▓▓▓▓▓▓▓██▓▓▓▓▓▓▓█████████▓▒▓█▓█████▓▓▓██▓▓▓▓▓▓▓▓▓▒▒▓▓▓▓▒▓▒▒▒▒▒▒▒▒▒▒▒▒▒▓▓▓▓▓██▓▓████▓█▓▓██▓▓▓▓▓▓▓▓▓▓█
▓▓▓▓▓▓▒▒▓░░▓█▓▓▓▓▓▓▒▒▓████▓▓▒▓▓▓▓▓▓████▓▓▒▒▒░▒▒▒▒▓▓▓▓▒▒▓▓▓▓▒▒▓▒▒▒▒▓▓▓▒▒▒▒▒▒█████▒▓▓▓▓██▓▓▓▒▓▓███▓▓▓▓▓██▒██▓▓▓▓▓▓▓▓▓▓▓▓▓▓▓▓▓▓▓▓▒▓▓▓▓▓▓▓▓▓▓▓▓▓▓▓▓▓▓▓▓▓▓▓▓▓▓▓▓▓▓▒▓▓▓▓██▓▓▓▓▓▓▓▓▓▓▓███████▓▒▓████▓▓▓▒████▓▒▒▒▓▓▓▓▓▓▓▓▓▓▓▓▓▓▓▓▓▓▓▓▒▒▒░▒▒▒▒▒▒▒▓▓▓████▓▓▓▓▒░▒▓▓▓▓▓▓▓▓▓██▓█
▓███▓▒▒▓▓▓▒▒▓▓▓█▓█▓█▓▓▓▓▓▓▓▓▓▓▓▒░▓▓▓▓▓████▓▓▓▓▓▓▓▓▓▓▓▓▓▓▓▓▓▓███████▓▒▒▓▓▒▓▒▒▒████▓▓▓▓▓▓▓██▓▓▓▓▓▓▓▓▒▒▓██▓██▓▓▓▓▓▓▓▒▒▓▒▒▓▓▓▓▓▓▒▒▒▒▒▒▒▒▒▒▒▒▒▒▒▒▒▒▒▒▒▒▓▓▓▓▓▓▒▒▒▒▒▒▒▒▓▓▓█▓▓██▓▓█▓▒▓▓█████▓▓▓████▓▓▓▓█████▓▓▓▓▓█▓▓▓████████▓▓▓▓▓▓▓▓▓▓▓▓▓▓▓▓▓▓▓████▓▓▒▒▒▒▒▒▒▓▓▒▓▓▓▓▓▓█▓█▓█
▓▓██▓▓▓█▓█▓▒▓████████▓░░▒▓██▓▓▓▓▓▓▓▓▓▓▓▓▓▓▓▓▓▓▓▓▓▓▓▓▓███████████████▒▒▓▓▒▓▓▓████▒▓▓██▓▓▓▓▓▓▓▓▓▓▓▓▒▒▒▓██▓▓▓▓▓▒▓▓▒▒▒▒▒▒▒▒▒▒▒▒▒▒▒▒▒▒▒▒▒▒░▒▒▒▒▒▒▒▒▒▒▒▒▒▒▓▓▓▒▒▒▒▒▒▒▒▒▒▓▓▓▓▓██▓▓▓▓▒▓▓████▓░▓▓▓▓▓▓▓████▓█▓██▓▓▓▓█▓▓▓███████████▓▓▓▓▓▓▓▓▓▓▓▓▓███▓▓▓████▓▓▓▓▒▒▒▒░░░░▒▓▓█████
▓▓▓▓▒▓▓▓▓▓▓▓██▓██▓▓██▓▓▓▓▓▓▓▓▓▓▓▓▓▓▓▓▓▓▓▓▓▓▓▓▓▓▓▓▓▓▓████████████████▒▒▒▒▒▓▓▓▓████▓▓▓▓▓▓▓▓▓▓▓▓▓▓▓▓▒▒▒▓▓█▓▓▓▓▓▒▓▓▒▒▒▒▒▒▒▒▒▒▒▒▒▒▒▒▒▒▒▒▒░░▒▒▒▒▒▒▒▒▒▒▒▒▒▒▒▒▒▒▒▒▒▒░▒▒▒▒▓▓▓▓███▓▓▓▓▒▒▓████▓▒▓▒▒▓▓▓▓▓▓▓▓████▓▓▓▓▓▓▓▓███████████████▓▓▓▓▓█▓█▓▓▓▓█▓▓▓▓▓▓▓▓▓▓▓▓▓▓▓▓▓▓▓▓▒▒▓▒▒▓▓
▒▓▒▒▒▒▓▓▓▒▒▓█████▓▓▓▓▓▓▓█▓▓▓▓▓▓▓▓▓▓▓▓▓▓▓▓▓▓███▓▓█████▓▓▒▒███████████▓▒▒▒▒▓▓█▓▓▓▓▓▓▒▒▓▓▓▓▓█▓▓▓▓▓▓▓▓▒▒▓▓▓▓▓▓▓▓▒▒▓▒▒▒░░▒▒▒▒▒▒▒▒▒▒▒░▒▒▒░░░░░░░░░▒▒▒▒▒▒▒▒▒▒▒▒▒▒▒▒░░▒▒▒▓▓▓▓▓▓█▓▓▓▒▒▒▓▓███▓▒▓▒▒▒░▓▓▓▓▓▓▓▓▓▓▓▓▓▓▓▓▓▓███████████▒▒▓███████▓▓▓▓██████████████▓▓█▓▓▓▓▓▓▓▓▓▓███
▓▓█▓▓▓██▓▓▓▓█████▓▓▓▓███▓██▓▓███▓▓▓▓▓▓▓▓███████▓▒▓█▓▓▓▓█████████████▓▒▒▓▓█▓▓▓▓█▓▒▒▒▓▓▓▓▓▓█▓▓▓▓▓▓▓▓▒▒▓▓▓▓▓▓▓▓▓▒▒▒▒▒░▒▒▒▒▒▒▒▒▒▒▒▒▒▒▒░░░░░░░░░░░░░░░▒▒▒▒▒▒▒▒▒▒▒▒▒▒▒▒▓▓▓████▓▓▓▒▒▒▒▓▓▓▓▓▓▓▓▒▒▒▓▓▓▓▓▓▓██▓▓▓▓██▓▓▓████████████▓▓█▓▒▓▓▒▓████████▓▓▓▓▓████████████▓██████▓▓
▓▓▓▓█████▓▓▓██████████████▓██▓▓▓██████████▓████▓▓▓███████▓▓██████████▓▒▒▒▒▒▓▒▓▓▓▒▒██████▓█▓▓▓▓▓▓▓▓▒▒▒▓▓▓▓▓▓▓▓▒▒▒▒▒▒▒▒▒▒▒░▒▒▒▒▒▒▒▒░░░░░░░░░░░░░░░░▒▒▒▒▒▒▒▒▒▒▒▒▒▒▒▒▓▓▓█████▓▓▓██████▓▓▓▓▓▓▒▒▓▓▒▒▒▓▒▓▓▓▒▓▓▓▓▓███████████████████▓▓█▓▓▓████████████▓▓▓▓██████████████▓█
██▓▓███████████████▓▓██▓███████▓███▓▒░░▓▓██▓█████▓▓▓▓▓█████████████▓▒▒▒▒▓▓▓▓▒▓▓▓▒▒▒▓▓▓▓▓▓▓▓▓▓▓▓▓▓▓▒▒▒▓▓▓▓▓▓▓▓▒▒▒▒▒▒▒▒▒░▒░▒▒▒▒▒▒▒▒░░░░░░░░░░░░░░░░▒▒▒▒▒▒▒▒▒▒▒▒▒▒▒▒▓▓▓▓▓▓██▓▓▓██████▓▓▓▓▓▓▒▒▒▒▒▒▒▒▒▓▓▓▒▓▓▓▓▓▓▓███████████▓▓▒▓▓▓████▓▓████▓░▓▓████████████████████████
███████████████▓▓████████████▓▒░▒▓▓█▓▓▓████▓▓▓█▒▒▓█████████████████▓▓▓▓▓▓████▓▓▓▒▒▒▒▒▓▓▓▓▓▓▓▓▓▓▓▓▓▓▒▒▓▓▓██▓▓▓▓▓▒▒▒▒▒░░░░░░░░▒▒▒▒▒▒░░░░░░░░░░░░░░░░▒▒▒▒▒▒▒▒▒▒▒▒▒▒▓▓▓▓█████▓▓▒▒▒▒▓▓▓▓▓▓▓▓▒▒▒▒▒░░░░░▒▓▓▓▓▓▓▓▓▓█████████████████▓▓▒▓█▓█████▓▓▓█▒▒▒▓▓███████████████████
█████████▓▓▓▓▓▓███████████████▓▓▓████▓▓▓▓▓▒▒▓██████████████████████████▓▓████▓▓▒▒▒▒▒▒▒▒▓▓▓▓▓▓▓▓▓▓▓▓▓▒▓▓▓▓▓▓▓▓▓▓▒▒▒▒░░░░▒░░░░▒▒▒▒▒▒░░░░░░░░░░░░░░░░▒▒▒▒▒▒▒▒▒▒▒▒▒▒▓▓▓▓▓████▓▓▒▒▒▒▓▓▓▓▓▓▓▒▒▒▒░░░░░░░▒▒▒▓▓▓██████████████████████████▒▓████████████▓▒▒▓▓▓██████████████
██████████████▓███▓▓▓▓██████████▓▓▓▓▓░░▒▓████████▓████████▓█▓█████████▓▓▓▓▓▓▓▓▒▒▒▒▒▒▒▒▒▓▓▓▓▓▓▓▓▓▓▓▓▓▓▓▓▓▓▓▓▓▓▓▓▓▒▒▒▒▒▒▒▒▒▒▒▒▒▒▒▒▒▒▒░░░░░░░░░░░░░░▒▒▒▒▒▒▒▒▒▒▒▒▒▒▓▓▓▓▓▓▓▓▓▓▓▓▓▓▓▓▓▓▓▓▒▓▓▒▒▒░░░░░░▒▒▓▓▓█████████████████████████████████▓▒▓▓▓█▓██████▓▓▓██████████████
█████████████████▓▒▒▓██████▓▓▓▓▓███████████▓▓█████████████▓▓███████████▓▓▓▓▓▓▒▒▒▒░▒▒▒▒▓▓▓▓▓▓▓▓▓▓▓▓▓▓▓▓▓▓▓▓▓▓▓▓▒▒▒▒▒▒░▒▒▒▒░░▒▒▒▒▒░░░░░░░░░░░░░░░░░░░░░▒▒▒▒▒▒▒▒▒▒▒▓▓▓▓▓▓▓▓▓▓▓▓▓▓▓▓▓▓▓▓▓▓███▓▓▓▓▓▒▒▒▒▓▓▓▓████████████████▓▓█▓████████████████▓░▒▓█▓▓██████████████████
██████████████████████▓▓▓███▒▓███████▓▓▓█▓▓████████████████████████████▓▓▓▒▒▒▒▒░░░▒▒▒▒▓▓▓▓▓▓▓▓▓▓▓▓▓▓▒▓▓▓▓▓▓▓▓▓▒▒▒▒▒░▒▒▒▒▒▒░▒▒▒▒▒▒░░░░░░░░░░░░░░░░░░░▒▒▒▒▒▒▒▒▒▒▒▒▓▓▓▓▓▓▓█▓▓▓▓▓▓▓▓▓██▓▒▒▒▒▒▒░░░░░░░░░░▒▒▓▓▓▓▓███████████▓▒▓▒▓█▓██████████████████▓▒▒██▓██████████████
██████████████████▓▓██▓▒▒████████▓▓▓█▓▓█▓▓▓███████████████▒▓████████▓▓▓▓▒▒▒▒▒░░░░░░▒▒▓▓▓▓▓▓▓█████▓▓▓▓▓██▓███▓▓▓▒▒▒▒▒▒▒▒▒▒▒░░▒▒▒▒▒▒░░░░░░░░░░░░░░░░░░▒▒▒▒▒▒▒▒▒▒▒▓▓████████▓▓▓▓▓▓▒▓▓▓▓▓▓▓▒▒▒░░░░░░░░░░░░▒▒▓▓▓▓██████████▓▓███▓▓▓▓▓██████████████████▓▒███████████████
█████████████████▓▒▒█████████▓▓██▓██▓▓▓▓▓▓▓▓██▓▒▒▓▒▒▒▓▓▓▓▓▒▓██████▓▓▓▓▓▒▒▒▒▒░░░░░░░▒▒▓▓▓▓▓▓▓████▓███▓▓▓████▓▓▓▒▒▒▒▒▒▒▒▒▒▒▒░▒▒▒▒▒▒▒░░░░░░░░░░░░░░░░░░░▒▒▒▒▒▒▒▒▒▒▒▓▓▓█████▓▓▓▓▓▓▓▓█▓▓▓▓▒▒▒▒▒░░░░░░░░░░░░░▒▒▒▓▓▓█████████▓▓▓▓▓▓▓▓▓▓▓▓▓████████████████████████████████
████████████████████████████████▓▓▓▓▓▓▓▓▓▓▒▒▓█▓▒▒▓▓▓▒▓▓▓▓▓▒▓▓▓▓▓▓▓▓▓▓▒▒▒▒▒▒▒░░░░░░░▒▒▓▓▓▓▓▓▓▓▓▓████▓▓▓▓████▓▓▒▒▒▒▒▒▒▒▒▒▒▒▒▒░▒▒▒▒▒░░░░░░░░░░░░░░░░░░░░▒▒▒▒▒▒▒▒▒▒▒▓▓▓██████▓▓▓▓▓▓▓▓▓██▓▓▒▒▒░░░░░░░░░░░░░░░▒▒▓▓▓███████████████▓▓▓▓█▓███▓▒████████████████████████████
███████████████████████████████████▓▒▒▒▒░▒▒▓██▓▓▓▓▓▒▒▓▓▓▓▓▒▓▓▓▓▓▓▓▓▒▒▒▒▒▒▒▒░░░░░░░░▒▒▒▓▓▓▓▓▓▓▓▓▓▓█▓▓▓▓████▓▓▒▒▒▒▒▒▒▒▒▒▒▒▒▒░▒▒▒▒░░░░░░░░░░░░░░░░░░░░░░░▒▒▒▒▒▒▒▒▒▒▒▓▓▓█████▓▓▓▓▓▓▓▓▓▓▓▓▓▒▒▒░░░░░▒▒▓▓▓███▓▓▓▓▒▒▒▓▓▓▓▓█████▓▓▒▒▒▒▒▓▓▓▓▓██▓▒▓███▓███████████████████████
███████████████████████████▓▓▓▓▓▓█▓▓▒░▒▒▒▓▓███▓▒▒▒▒▒▒▓▓▓█▓▓▓▓▓▓▓▓▒▒▒▒▒▒▒▒▒░░░░░░░░░▒▒▒▒▓▓▓▓▓▓▓▓▓▓▓▓▓▓▓██▓▓▓▒▒▒▒▒▒▒▒▒▒▒▒▒▒▒▒▒▒▒▒░░░░░░░░░░░░░░░░░░░░░░░░▒▒▒▒▒▒▒▒▒▒▒▓▓▓████▓▓▓▓▓▓▓▓▓▓▒▒▒▒▓███▓▒░░░░░░░░░░░░░░▒▒▒▒▓▓▓▓████▓▓▒▒▒▒▒▒▓▒▒▒██▓▒▓██▓▓▓██████████████████████
████████████████████████████▒░░▒▒▓▓▓▓▒▒▒▓▓▓██▓▓▒▒▒▒▒▒▓▓▓▓▓▓▓▓▓▓▒▒▒▒▒▒▒▒▒▒░░░░░░░░░░▒▒▒▒▓▓▓▓▓▓▓▓▓▓▓▓▓▓▓▓▓▓▓▓▒▒▒▒▒▒▒▒▒▒▒▒▒▒▒▒▒▒▒▒░░░░░░░░░░░░░░░░░░░░░░░▒▒▒▒▒▒▒▒▒▒▓▓▓▓▓▓██▓▓▓▓▓▓▓▓▓▓▓▒▓█▓▒▒░░░░░░░░░░░░░░░░░░░▒▒▒▒▓▓▓▓▓██▓▓▒▒▒▒▒▒▒▒▒▓██▓▒▓▓█▓▒▒▓████▓▓███████████████
████████████████████████▓███▒░▒▒▓▓▓▓▓▒▒▒▒▓▓▓▓▓▓▒▒▒▒▒▒▓▓▓▓▓▓▓▓▒▒▒▒▒▒▒▒▒░░░░░░░░░▒▒▓███████████▓▓▓▓▓▓▓▓▓▓▓▓▓▓▒▒▒▒▒▒▒▒▒▒▒▒▒▒▒▒▒▒▒▒░░░░░░░░░░░░░░░░░░░░░░░▒▒▒▒▒▒▒▒▒▓▒▓▓▓▓▓▓█▓▓▓▓▓▓▓▒▓▓▓▓▓▓▒▒▒░░░░░░░░░░░░░░░░░░░░▒▒▒▒▓▓▓▓▓▓▓▓▓▒▒▒▒▒▒▒▒▒▓█▓▓▓██▓░░▒▓▓▓▓▓▓███████████████
███████████████████▓▓▓▓▓████▓▒▓▓▓▓▓▒▒▒▒▒▒▒▓▓▓▓▓▒▒▒▒▒▓▓▓▓▓▓▓▓▒▒▒▒▒▒▒▒▒░░▒▒▓██████████████████████▓▓██▓▓▓▓▓▓▓▓▓▒▒▒▒▒▒▒▒▒▒▒▒░░░░░░░░░░░░░░░░░░░░░░░░░░░░░▒▒▒▒▒▒▒▒▓▓▓▓▓▓▓▓▓██▓▓▓▓▓▓▓▓▓▓███▓▓▒▒▒░░░░░░░░░░░░░░░░░░▒▒▒▒▓▓▓▓▓▓▓▓▓▓▒▒▒▒▒▒▒▒▓▓▓▓▓███▓▓▓▓▓▓▓▓▓███████████████
██████████████████▓▒▓▓▓█████▓▓▓▒▒▒▒▒▒▒▒▒▒▒▓▓▓▓▓▓▒▒▒▓▓▓▓▓▓▓▓▓▒▒▓▓▓▒▒▒▒▒▓▓█▓██████████████████████▓▓▓███▓▓▓▓▓▓▒▒▒▒▒▒▒▒▒▒▒▒▒░░░░░░░░░░░░░░░░░░░░░░░░░░░░░▒▒▒▒▒▒▒▒▒▓▓▓▓▓▓▓▓▓▓▓▓▓▓▓▓▓▓████████████████▓▒▒░░░░░░░░░░▒▒▒▒▓▓▓▓▓▓▓▓▓▓▒▒▒▒▒▒▒▒▒▓▓▓▓▓▓▓▓▓▓▓▓▒▒▒▓██████████████
██████████████████▓▒▒▓▓█████▓▒▒▒▒▒▒▒▒▒▒▒▒▒▒▓▓▓▓▓▓▒▓▓▓▓▓▓▓▓▓▓███▓█▒▒▒████▓▓█████████████████████▓▓▓█▓█▓▒▓▓▓▓▒▒▒▒▒▒▒▒▒▒▒▒▒░░░░░░░░░░░░░░░░░░░░░░░░░░░░░░░▒▒▒▒▒▒▒▒▓▓▓▓▓▓▓▓▓▓▓▓▓▓▓▓▓▓██████▓▓██████████▓▓█▓▒░░░░░░▒▒▒▒▓▓▓▓▓▓▓▓▓▓▒▒▒▒▒▒▒▒▒▒▒▒▓▓▓▓▓▓▓▓▓▒▒▒▓██████████████
██████████████████▓▒▒▓▓▓▓▓▓▓▓▒▒▒▒▒▒▒▒▒▒▒▒▒▒▓▓▓▓▓▓▓▓▓▓▓▓▓▓▓░░▒████▒▓██▓████▓█▓▓▓▓▓▓▓▒▒▒▓▓████████████▒▓▓▓▓▓▓▓▓▓▓▓▓▓▓▓▓▓▓▓▓▒▓▒▒▒▒▒▒▒▒▒▒▒▒░░▒▒▒▒▒▒▒▒▒▒▒▒▒▓▒▓▓▓▓▓▓▓▓▓██▓▓▓▓████████████████▓▒▒▒░░░░▒▓█▓▓▓▓▒▓▓░░░░▒▒▒▒▒▓▓▓▓▓▓▓▓▓▓▓▒▒▒▒▒▒▒▒▒▒▒▒▒▒▓▓▓▓▓▓▓▓▓▓██████████████
██████████████████▓▒▒▓▓▓▓▓▓▓▓▒▒▒▒▒▒▒▒▒▒▒▒▒▒▓▓▓▓▓▓▓▓▓▓▓▓▓▓▓▓▓▓███▓▒▓█████████████████████████████████▓██▓▓▓▓▓▓▓▓▓▓▓▓▓▓▓▓▓▒▒▒▒▒▒▒▒▒▒▒▒▒▒▒░░▒▒▒▒▒▒▒▒▒▒▒▒▒▒▓▓▓▓▓▓▓▓▓▓███▓▓▓████████████████████████████████▓▓▒░░░░▒▒▒▒▒▓▓▓▓▓▓▓▓▓▓▒▒▒▒▒▒▒▒▒▒▒▒▒▒▒▓▓▓▓▓▓▓▓███████████████
██████████████████▓▒▒▓▓▓▓▓▓▓▓▒▒▒▒▒▒▒▒▒▒▒▓▓▓▓▓▓▓▓▓▓▓▓▓▓▓▓▓▓▓████▓▒▒████████████████████████████████████▓▓▓▓▓▓▓▓▓▓▓▓▓▓▓▓▓▓▓▓▓▒▒▒▒▒▒▒▒▒▒▒▒░░▒▒▒▒▒▒▒▒▒▒▒▒▒▓▓▓▓▓▓▓▓▓▓█████▓▓▓▓████████████████████████████████░░░░░▒▒▒▒▓▓▓▓▓▓▓▓▓▓▓▓▓▒▒▒▒▒▓▒▒▒▒▒▓▓▓▓▓▓▓▓▓▓███████████████
██████████████████▓▓▓▓▓▓▓▓▓▓▓▒▒▒▒▒▒▓▓▓▓▓▓▓▓▓▓▓▓▓▓▓▓▓▓▓▓▓██▓▒▓▓█▓▒▒▓██████████████████████████████████▓▓▓▓▓▓▓▓▓▓▓▓▓▓▓▓▓▓▓▓▓▓▒▒▒▒▒▒▒▒▒▒▒▒░░▒▒▒▒▒▒▒▒▒▒▒▒▒▓▓▓▓▓▓▓▓▓▓██████▓▓▓▓██████████▓███████████████▓▓▒░░░░░░░▒▒▒▒▓▓▓▓▓▓▓█▓▓▓▓▓▓▓▓▓▓▒▒▓▒▒▒▒▓▓▓▓▓▓▓▓▓███████████████
██████████████████▓▓▓▓▓▓▓▓▓▓▓▓▓▓▓▓▓▓▓▓▓▓▓▓▓▓▓▓▓▓▓▓▓████▓▓▓▒░▒▓▓▒▒▒▒▒▓███████████████████████████████▓▓▓███▓▓▓▓▓▓▓▓▓▓▓▓▓▓▓▓▓▓▒▒▒▒▒▒▒▒▒▒▒░░▒▒▒▒▒▒▒▒▒▒▒▒▓▒▓▓▓▓▓▓▓▓▓███████▓█▓█████████▓▓▓▓▓▓▓▒▒░░░░░░░░░░░░░░░░░▒▒▒▒▒▓▓▓▓▓▓▓███▓▓▓▓▓▓▓▓▓▓▓▓▓▓▓▓▓▓▓▓▓▓▓████████████████
██████████████████▓▓▓▓▓▓▓▓▓▓▓▓▓▓▓▓▓▓▓▓▓▓▓▓▓▓▓▓▓▓▓▓██████▓▓▓▒▒▓▓▒▒▒▒▒▒▒▓▓▓▓█████████████████████████▓▓▓███▓▓▓▓▓▓▓▓▓▓▓▓▓▓▒▓▒▒▒▒▒▒▒▒▒▒▒▒▒▒░▒▒▒▒▒▒▒▒▒▒▒▒▒▒▒▒▒▓▓▓▓▓▓▓████████▓███████████▓▓▓▓▓▓▒▒░░░░░░░░░░░░░░░░░▒▒▒▒▒▓▓▓▓▓▓█████▓▓▓▓▓▓▓▓▓▓▓▓▓▓▓▓▓▓▓▓▓▓████████████████
██████████████████▓▓▓▓▓█▓▓▓▓▓▓▓▓▓▓▓▓▓▓▓▓▓▓▓▓▓▓▓▓▓▓██████▓▓▓▓▓▓▓▒▒▒▒▒▒▒▒▒▒▒▒▒▒▒▒▒▒▓▓▓▓▓██▓█████████▓█▓███▓█▓▓▓▓▓▓▓▓▓▓▓▓▓▒▒▒▒▒▒▒▒▒▒▒▒▒▒▒▒░▒▒▒▒▒░▒▒▒▒▒▒▒▒▒▒▒▓▓▓▓▓▓▓▓████████▓████████████▓▓▓▓▒▒▒░░░░░░░░░░░░░░░▒▒▒▒▒▓▓▓▓▓▓███████▓▓▓▓▓▓▓▓▓▓▓▓▓▓▓▓▓▓▓▓█████████████████
███████████████████▓▓██████████████████████████████████████▓▓████▓▓▓▓▓▓▓▓▓▓▓▓▓▓▓▓██████████████████▓████████████▓█▓▓▓▓▓▓▓▓▓▓▓▓▓▒▓▓▓▓▓▓▓░▒▓▓▓▓▓▓▓▓▓▓▓▓▓▓▓█▓▓▓██████████████████████████████▓▓▓▓▓▓▓▓▓▓▒▓▓▓▓▓▓▓▓▓▓▓▓▓█████████████████████████████████████████████████